...###
..##.#.####
.##..###..#
##........#
#......#..#
###....#..#
..#..#....#
.##.#######
.#...#.@##
.#.#...##
.#######